10 39 36 0
Sa.a. .a. .a.a. . .a.a.a. .a. .a.a. . .a.a. .a. .a.a. . .a.a.a. .a. .b.a. . .
a   a   a a a   a a a   a   a a a   a a   a   a a a   a a a   a   a b b   a a
.a.a.a.a. .a.a.a.a.a.a.a.a.a. .a.a.a.a.a.a.a.a. .a.a.a.a.a.a.a.a.a. .a.b.a.a.
a   a   a a   a         a   a a   a   a   a   a a   a         a   a b   b   a
.a.a. . .a.a. .a. . .a.a. . .a.a. .a. .a.a. . .a.a. .a. . .a.a. . .a.a. .a. .
a       a   a   a   a   a   a   a   a       a   a   a   a   a   a   b   b    
.a.a.a. .a. . .a.a.a.a.a.a. .a. . .a.a.a.a.a. .a. . .a.a.a.a.a.a. .a. . .a.a.
  a     a a   a         a   a a   a   a a     a a   a         a   a b   b   a
.a. .a. . .a. .a.a.a.a. .a. . .a. .a.a.a. .a. . .a. .a.a.a.a. .a. . .a. .b.b.
a a   a   a a   a a a a   a   a a   a a a   a   a a   a a a a   a   b a   a b
.a.a.a. . .a.a.a. .a.a.a.a. . .a.a.a. .a.a.a. . .a.a.a. .a.a.a.a. .b.a.a.a. .
a a   a a         a a     a a         a a   a a         a a     a b         b
.a.a. .a.a.a.a. .a. .a.a. .a.a.a.a. .a.a.a. .a.a.a.a. .a. .a.a. .b.b.b.b.b.b.
    a a   a   a   a     a a   a   a   a   a a   a   a   a     a b   b   a   b
.a.a.a.a.a. .a. .a.a.a.a.a.a.a. .a. .a.a.a.a.a.a. .a. .b.b.b.b.b.b.b. .a. .b.
a a     a   a   a a a a     a   a   a a a     a   a   b a a a     b   a   b a
. .a.a.a.a. . .a. .a. .a.a.a.a. . .a. . .a.a.a.a. . .a. .a. .b.b.b.a. . .b. .
a     a a   a   a     a           a   a     a a   a   b     b           b   a
.a.a.a.a. .a.a. . .a.a.a. .a. .a.a. . .a.a.a.a. .a.a. .b.b.b.b. .a.b.b.b. . .
a   a   a a a   a a a   a   a a a   a a   a   a a a   b a a   a   b a a   a a
.a.a.a.a. .a.a.a.a.a.a.a.a.a. .a.a.a.a.a.a.a.a. .a.a.a.b.b.b.b.b.b. .a.a.a.a.
    a   a a   a         a   a a   a     a   a a   a         a   a a   a      
.a.a.a. .a.a. .a. . .a.a. . .a.a. .a. .a.a.a. .a.a. .a. . .a.a. . .a.a. .a. .
a     a a   a   a   a   a   a   a   a       a a   a   a   a   a   a   a   a  
.a.a.a. .a. . .a.a.a.a.a.a. .a. . .a.a.a.a.a. .a. . .a.a.a.a.a.a. .a. . .a.a.
    a   a a   a   a         a a   a       a   a a   a   a         a a   a    
.a. .a. . .a. .a.a.a.a. .a. . .a. .a.a.a. .a. . .a. .a.a.a.a. .a. . .a. .a.a.
a a   a   a a   a a a a   a   a a   a a a   a   a a   a a a a   a   a a   a a
.a.a.a. . .a.a.a. .a.a.a.a. . .a.a.a. .a.a.a. . .a.a.a. .a.a.a.a. . .a.a.a. .
a     a a     a   a a   a a a   a     a     a a     a   a a   a a a   a     a
.a. .a.a.a.a.a. .a. .a. . .a.a.a.a. .a.a. .a.a.a.a.a. .a. .a. . .a.a.a.a. .a.
    a a   a   a   a     a a   a   a   a   a a   a   a   a     a a   a   a   a
.a.a.a.a.a. .a.a.a.a.a.a.a.a.a. .a. .a.a.a.a.a.a. .a.a.a.a.a.a.a.a.a. .a. .a.
a a   a a   a   a a a a     a   a   a a a   a a   a   a a a a     a   a   a a
. . .a.a.a. . .a. .a. . .a.a.a. . .a. . . .a.a.a. . .a. .a. . .a.a.a. . .a. .
a a   a a   a   a a a a     a   a   a a a   a a   a   a a a a     a   a   a a
.a.a. .a. .a.a. . .a.a.a. .a. .a.a. . .a.a. .a. .a.a. . .a.a.a. .a. .a.a. . .
a   a   a a a   a a a   a   a a a   a a   a   a a a   a a a   a   a a a   a a
.a.a.a.a. .a.a.a.a.a.a.a.a.a. .a.a.a.a.a.a.a.a. .a.a.a.a.a.a.a.a.a. .a.a.a.a.
a   a   a a   a         a   a a   a   a   a   a a   a         a   a a   a   a
.a.a. . .a.a. .a. . .a.a. . .a.a. .a. .a.a. . .a.a. .a. . .a.a. . .a.a. .a. .
a       a   a   a   a   a   a   a   a       a   a   a   a   a   a   a   a    
.a.a.a.a.a. . .a.a.a.a.a.a. .a. . .a.a.a.a.a.a.a.a.a.a.a.a.a.a.a. .a. . .a.a.
  a     a a   a         a   a a   a   a a     a a   a         a   a a   a   a
.a. .a. . .a.a.a.a.a.a.a.a. . .a. .a.a.a. .a. . .a. .a.a.a.a. .a. . .a. .a.a.
a a   a   a a   a a a a   a   a a   a a a   a   a a   a a a a   a   a a   a a
.a.a.a.a.a.a.a.a. .a.a.a.a.a.a.a.a.a.a.a.a.a. . .a.a.a. .a.a.a.a. . .a.a.a. .
a a   a a         a a     a a         a a   a a         a a     a a         a
.a.a. .a.a.a.a. .a. .a.a. .a.a.a.a. .a.a.a. .a.a.a.a. .a. .a.a. .a.a.a.a. .a.
    a a   a   a   a     a a   a   a   a   a a   a   a   a     a a   a   a   a
.a.a.a.a.a. .a. .a.a.a.a.a.a.a. .a. .a.a.a.a.a.a. .a. .a.a.a.a.a.a.a. .a. .a.
a a     a   a   a a a a     a   a   a a a     a   a   a a a a     a   a   a a
. .a.a.a.a. . .a. .a. .a.a.a.a. . .a. . .a.a.a.a. . .a. .a. .a.a.a.a. . .a. .
a     a a   a   a     a           a   a     a a   a   a     a           a   a
.a.a.a.a. .a.a. . .a.a.a. .a. .a.a. . .a.a.a.a. .a.a. . .a.a.a. .a. .a.a. . .
a   a   a a a   a a a   a   a a a   a a   a   a a a   a a a   a   a a a   a a
.a.a.a.a. .a.a.a.a.a.a.a.a.a. .a.a.a.a.a.a.a.a. .a.a.a.a.a.a.a.a.a. .a.a.a.a.
    a   a a   a         a   a a   a     a   a a   a         a   a a   a      
.a.a.a. .a.a. .a. . .a.a. . .a.a. .a. .a.a.a. .a.a. .a. . .a.a. . .a.a. .a. .
a     a a   a   a   a   a   a   a   a       a a   a   a   a   a   a   a   a  
.a.a.a. .a. . .a.a.a.a.a.a. .a. . .a.a.a.a.a. .a. . .a.a.a.a.a.a. .a. . .a.a.
    a   a a   a   a         a a   a       a   a a   a   a         a a   a    
.a. .a. . .a. .a.a.a.a. .a. . .a. .a.a.a. .a. . .a. .a.a.a.a. .a. . .a. .a.a.
a a   a   a a   a a a a   a   a a   a a a   a   a a   a a a a   a   a a   a a
.a.a.a. . .a.a.a. .a.a.a.a. . .a.a.a. .a.a.a. . .a.a.a. .a.a.a.a. . .a.a.a. .
a     a a     a   a a   a a a   a     a     a a     a   a a   a a a   a     a
.a. .a.a.a.a.a. .a. .a. . .a.a.a.a. .a.a. .a.a.a.a.a. .a. .a. . .a.a.a.a. .a.
    a a   a   a   a     a a   a   a   a   a a   a   a   a     a a   a   a   a
.a.a.a.a.a. .a.a.a.a.a.a.a.a.a. .a. .a.a.a.a.a.a. .a.a.a.a.a.a.a.a.a. .a. .a.
a a   a a   a   a a a a     a   a   a a a   a a   a   a a a a     a   a   a a
. . .a.a.a. . .a. .a. . .a.a.a. . .a. . . .a.a.a. . .a. Da. . .a.a.a. . .a. .